0,0,0,0,0,0,0,0,0,0,0,0,0,0,0,0
0,0,0,0,0,0,1,2,3,4,0,0,0,0,0,0
0,0,0,0,0,5,6,7,8,9,10,0,0,0,0,0
0,0,0,0,11,0,12,13,14,15,0,16,0,0,0,0
0,0,0,0,17,18,19,20,21,22,23,24,0,0,0,0
0,0,0,11,25,26,27,28,29,30,31,32,16,0,0,0
0,0,0,17,18,33,34,35,36,37,38,23,39,0,0,0
0,0,40,41,42,43,44,45,46,47,48,49,50,51,0,0
0,40,52,53,43,54,55,56,57,58,59,48,60,61,51,0
62,63,62,63,62,64,65,66,67,68,69,70,62,63,62,63
71,72,71,72,71,64,73,74,75,76,69,72,71,72,71,72
62,70,62,70,62,64,77,78,79,80,69,70,62,70,62,70
71,72,71,72,71,64,77,80,77,80,69,72,71,72,71,72
81,81,81,81,81,81,81,81,81,81,81,81,81,81,81,81
82,83,82,83,82,83,82,83,82,83,82,83,82,83,82,83
84,85,84,85,84,85,84,85,84,85,84,85,84,85,84,85
81,81,81,81,81,81,81,81,81,81,81,81,81,81,81,81
82,83,82,83,82,83,82,83,82,83,82,83,82,83,82,83
84,85,84,85,84,85,84,85,84,85,84,85,84,85,84,85
82,83,82,83,82,83,82,83,81,81,81,81,81,81,81,81
84,85,84,85,84,85,84,85,84,85,84,85,84,85,84,85
82,83,81,81,81,81,82,83,82,83,82,83,82,83,82,83
84,85,84,85,84,85,84,85,84,85,84,85,84,85,84,85
82,83,82,83,82,83,82,83,82,83,81,81,81,81,81,81
81,81,81,81,81,81,81,81,84,85,84,85,84,85,84,85
82,83,82,83,82,83,82,83,82,83,82,83,82,83,82,83
84,85,84,85,84,85,81,81,81,81,81,81,84,85,84,85
82,83,82,83,82,83,82,83,82,83,82,83,82,83,82,83
81,81,81,81,81,81,84,85,84,85,84,85,84,85,84,85
82,83,82,83,82,83,82,83,81,81,81,81,81,81,81,81
84,85,84,85,84,85,84,85,84,85,84,85,84,85,84,85
81,81,81,81,81,81,81,81,81,81,81,81,81,81,84,85
82,83,82,83,82,83,82,83,82,83,82,83,82,83,82,83
84,85,84,85,84,86,87,0,88,85,81,81,81,81,81,81
82,83,82,83,89,90,0,0,91,92,82,83,82,83,82,83
84,86,87,0,0,0,0,0,0,0,0,0,81,81,81,81
89,90,0,0,0,0,0,0,0,0,0,0,91,92,82,83
0,0,0,0,0,0,0,0,0,0,0,0,0,0,88,85
0,0,0,0,0,0,0,0,0,0,0,0,0,0,91,92
93,93,93,93,93,93,93,93,93,93,93,93,93,93,93,93
81,81,81,81,81,81,94,95,95,95,95,95,95,95,95,95
96,97,96,97,96,98,94,95,95,95,95,95,95,95,95,95
99,100,99,100,101,102,95,95,95,95,95,95,95,95,95,95
96,97,81,81,81,81,81,81,94,95,95,95,95,95,95,95
99,100,99,100,99,100,99,100,94,103,81,81,81,81,81,81
96,97,96,97,96,98,104,105,95,103,96,97,96,97,96,97
96,97,104,105,106,105,95,95,95,95,106,107,81,81,96,97
99,100,94,95,95,95,95,95,95,95,95,103,99,100,99,100
96,98,95,103,81,81,81,81,81,81,94,103,81,81,81,81
101,102,95,103,99,100,99,100,99,100,94,103,99,100,99,100
108,95,95,103,96,97,96,98,104,105,95,95,106,107,96,97
95,95,81,81,81,81,81,81,94,95,95,95,95,103,99,100
95,103,109,97,96,97,96,98,94,95,95,95,95,95,106,105
95,95,110,111,81,81,81,81,81,81,81,81,81,81,94,95
95,95,95,112,96,97,96,97,96,97,96,97,96,98,94,95
95,95,95,103,99,100,99,100,99,100,99,100,101,102,95,95
95,95,95,103,109,97,96,97,81,81,81,81,113,95,95,95
95,95,95,95,110,111,99,100,99,100,99,100,94,95,95,95
81,81,94,103,81,81,81,81,81,81,96,98,94,95,95,95
99,100,94,103,99,100,99,100,99,100,101,102,95,95,95,95
96,97,94,95,106,107,96,97,96,97,81,81,81,81,94,95
96,97,94,95,95,103,109,97,96,97,96,97,96,97,94,95
99,100,94,95,95,95,110,111,81,81,81,81,99,100,94,95
96,97,94,95,95,95,95,108,109,97,96,97,96,98,94,95
99,100,94,95,95,95,95,95,110,111,99,100,101,102,95,95
96,98,94,95,95,95,95,95,95,112,81,81,113,95,95,95
101,102,95,95,95,95,95,95,95,103,99,100,94,95,95,95
108,95,95,95,95,95,95,95,95,95,106,105,95,95,95,95
95,95,95,95,95,95,95,95,95,95,95,95,95,95,95,95
81,81,81,81,81,81,94,95,95,95,95,95,95,95,95,95
99,100,99,100,99,100,94,95,95,95,95,95,95,95,95,95
109,97,81,81,81,81,81,81,94,103,81,81,81,81,81,81
110,111,99,100,99,100,99,100,94,103,99,100,99,100,99,100
95,112,96,97,96,98,106,105,95,103,109,97,96,97,96,98
95,103,99,100,101,102,95,95,95,95,110,111,81,81,81,81
81,81,81,81,113,95,95,95,95,95,95,108,109,97,96,97
96,97,96,97,94,95,95,95,95,95,95,95,106,105,106,105
99,100,81,81,81,81,94,95,95,95,95,95,95,95,95,95
96,97,96,97,96,98,94,103,81,81,81,81,81,81,94,95
81,81,81,81,101,102,95,103,99,100,99,100,99,100,94,95
109,97,96,98,108,95,95,103,109,97,81,81,81,81,81,81
110,111,101,102,95,95,95,95,110,111,99,100,99,100,99,100
95,108,108,95,95,95,95,95,95,108,109,97,81,81,81,81
95,95,95,95,95,95,95,95,95,95,110,111,99,100,99,100
81,81,81,81,114,115,116,117,116,117,115,118,81,81,81,81
99,100,99,100,119,93,93,93,93,93,93,120,99,100,99,100
96,97,96,98,94,95,95,95,95,95,95,103,109,97,96,97
81,81,81,81,94,95,95,95,95,95,95,95,110,111,99,100
96,97,96,98,94,95,95,95,95,95,95,95,95,108,109,97
99,100,81,81,81,81,81,81,94,95,95,95,95,95,110,111
96,97,96,97,96,97,96,98,94,95,95,95,95,95,95,108
96,97,96,97,96,97,96,97,81,81,81,81,81,81,81,81
99,100,99,100,99,100,99,100,99,100,99,100,99,100,99,100
109,97,81,81,81,81,96,98,106,105,106,105,106,105,106,105
110,111,99,100,99,100,101,102,95,95,95,95,95,95,95,95
95,108,109,97,81,81,81,81,81,81,81,81,81,81,81,81
95,95,110,111,99,100,99,100,99,100,99,100,99,100,99,100
81,81,81,81,81,81,81,81,96,98,109,97,96,98,109,97
99,100,99,100,99,100,99,100,101,102,110,111,101,102,110,111
96,97,96,98,104,105,106,105,108,95,95,108,108,95,95,108
81,81,81,81,94,95,95,95,95,95,95,95,95,95,95,95
96,97,96,97,121,122,123,122,123,122,123,122,123,122,123,122
99,100,99,100,124,125,126,125,126,125,126,125,126,125,126,125
81,81,81,81,81,81,81,81,81,81,81,81,81,81,81,81
99,100,99,100,99,100,99,100,99,100,99,100,99,100,99,100
96,97,96,97,96,97,96,97,96,97,81,81,81,81,81,81
81,81,81,81,81,81,81,81,127,128,96,97,96,97,96,97
99,100,99,100,99,100,99,100,129,130,99,100,99,100,99,100
109,97,81,81,81,81,96,97,96,97,96,98,109,97,96,98
110,111,99,100,99,100,99,100,99,100,101,102,110,111,101,102
95,112,81,81,127,128,96,97,81,81,81,81,81,81,81,81
95,103,99,100,129,130,99,100,99,100,99,100,99,100,99,100
95,103,96,97,96,97,96,97,96,97,127,128,96,97,96,98
81,81,81,81,99,100,99,100,99,100,129,130,81,81,81,81
96,97,96,97,96,97,96,97,96,97,96,97,127,128,96,98
99,100,81,81,81,81,81,81,81,81,81,81,129,130,101,102
96,97,96,97,96,97,96,97,96,97,96,97,96,97,113,95
81,81,81,81,81,81,81,81,99,100,99,100,99,100,94,95
109,97,127,128,96,97,96,97,96,97,96,97,96,98,94,95
110,111,129,130,81,81,81,81,81,81,99,100,101,102,95,95
95,112,109,97,96,97,96,97,96,97,96,97,81,81,81,81
81,81,81,81,96,97,96,97,96,97,96,97,96,97,96,98
99,100,99,100,99,100,99,100,81,81,81,81,81,81,81,81
96,97,81,81,81,81,96,97,96,97,96,98,109,97,96,97
99,100,99,100,99,100,99,100,99,100,101,102,110,111,99,100
81,81,81,81,81,81,81,81,96,97,81,81,81,81,81,81
99,100,99,100,99,100,99,100,99,100,99,100,99,100,99,100
109,97,96,97,96,97,81,81,81,81,81,81,81,81,96,97
110,111,99,100,99,100,99,100,99,100,99,100,99,100,99,100
95,112,96,97,96,97,96,97,81,81,81,81,81,81,96,98
95,103,99,100,99,100,99,100,99,100,99,100,99,100,101,102
95,103,109,97,96,97,96,97,96,97,81,81,81,81,81,81
95,95,110,111,99,100,99,100,99,100,99,100,99,100,99,100
81,81,81,81,81,81,81,81,81,81,81,81,81,81,81,81
99,100,99,100,99,100,99,100,99,100,99,100,99,100,99,100
96,97,96,97,96,97,96,97,96,97,96,97,96,97,96,97
